0000000000000000000000000000000000000000000000000000000000000000000000000000000000000000000000000000000000001111100000000000000
0000000000000000000000000000000000000000000000000000000000000000000000000000000000000000000000000000000000111111111000000000000
0000000000000000000000000000000000000000000000000000000000000000000000000000000000000000000000000000000001110001111110000000000
0000000000000000000000000000000000000000000000000000000000000000000000000000000000000000000000000000000011000000001111000000000
0000000000000000000000000000000000000000000000000000000000000000000000000000000000000000000000000000000110000000000111000000000
0000000000000000000000000000000000000000000000000000000000000000000000000000000000000000000000000000000100000000000011100000000
0000000000000000000000000000000000000000000000000000000000000000000000000000000000000000000000000000001000011100000001100000000
0000000000000000000000000000000000000000000000000000000000000000000000000000000000000000000000000000001000111111000001100000000
0000000000000000000000000000000000000000000000000000000000000000000000000001000000000000000000000000000001100111000001100000000
0000000000000000000000000000000000000000000000000000000000000000000000000001000000000000000000000000000010000011000001100000000
0000000000000000000000000000000000000000000000000000000000000000000000000011000000000000000000000000000000000001100001100000000
0000000000000000000000000000000000000000000000000000000000000000000000000111011000000000000000000000000000000001100001100000000
0000000000000000000000000000000000000000000000000000000000000000000000000100101000000000000000000000000000000001000001100000000
0000000000000000000000000000000000000000000000000000000000000000000000000011001000000000000000000000000000000001000001000000000
0000000000000000000000000000000000000000000000000000000000000000000111111101001110000000000000000000000000000011000001000000000
0000000000000000000000000000000000000000000000000000000000000000001100000000001010000000000000000000000000000010000011000000000
0000000000000000000000000000000000000000000000000000000000000000011000000000001010000000000000000000000000000110000010000000000
0000000000000000000000000000000000000000000000000000000000000000110000000000001011000000000000000000000000000100000010000000000
0000000000000000000000000000000000000000000000000000000000000000101100000000001001000000000000000000000000001100000100000000000
0000000000000000000000000000000000000000000000000000000000000001111100000000001001010000000000000000000000001000001100000000000
0000000000000000000000000000000000000000000000000000000000001111010110000000001001010000000000000000000000011100001000000000000
0000000000000000000000000000000000000000000000000000000000011000100010000000001001001000000000000000000000010000010000000000000
0000000000000000000000000000000000000000000000000000000000011000011100000000001000001000000000000000000000110000010000000000000
0000000000000000000000000000000000000000000000000000000000000000000000000000000000000000000000000000000000100000100000000000000
0000000000000000000000000000000000000000000000000000000000010000000000000000000000000100000000000000000000100000100000000000000
0000000000000000000000000000000000000000000000000000000000011000000000000000000000000100000000000000000001000001100000000000000
0000000000000000000000000000000000000000000000000000000000001000000000000000000000000100000000000000000001000001000000000000000
0000000000000000000000000000000000000000000000000000000000001100000000000000000000000110000000000000000001000001000000000000000
0000000000000000000000000000000000000000000000000000000000000110000000000000000000000010000000000000000001000001000000000000000
0000000000000000000000000000000000000000000000000000000000000001000000000000000000000010000000000000000001000001000000000000000
0000000000000000000000000000000000000000000000000000000000000000010000000000000000000011000000000000000001000001000000000000000
0000000000000000000000000000000000000000000000000000000000000000001000000000000000000011000000000001111110000001000000000000000
0000000000000000000000000000000000000000000000000000000000000000000100000000000000000011100000011111111111110001000000000000000
0000000000000000000000000000000000000000000000000000000000000000000010000000000000000001111111110000000000011100000000000000000
0000000000000000000000000000000000000000000000000000000000000000000011000000000000000000111110000000000000000110000000000000000
0000000000000000000000000000000000000000000000000000000000000000000001000000000000000000000000000000000000000011000000000000000
0000000000000000000000000000000000000000000000000000000000000000000001000000000000000000000000000000000000000011100000000000000
0000000000000000000000000000000000000000000000000000000000000000000001000000000000000000000000000000000000000001110000000000000
0000000000000000000000000000000000000000000000000000000000000000000011000000000000000000000000000000000000000000110000000000000
0000000000000000000000000000000000000000000000000000000000000000000011000000000000000000000000000000000000000000111000000000000
0000000000000000000000000000000000000000000000000000000000000000000011000000000000000000000000000000000000000000011000000000000
0000000000000000000000000000000000000110000000000000000000000000000011000000000000000000000000000000000000000000011100000000000
0000000000000000000000000000000000011100000000000000000000000000000011000000000000000000000000000000000000000000001100000000000
0000000000000000000000000000000111101110000000000000000000000000000011000000000000000000000000000000000000000000001100000000000
0000000000000000000000000111111100001001000000000000000000000000000011000000000000000000000000000000000000000000001100000000000
0000000000000000000000111110001111101011000000000000000000000000000011000000000000000000000000000000000000000000001100000000000
0000000000000000000011100011110000110010000000000000000000000000000011000000000000000000000000000000000000000000000110000000000
0000000000000000000110000110110000001010000000000000000000000000000011000000000000000000000000000000000000000000000110000000000
0000000000000000001100000100011000000100000000000000000000000000000001000000000000000000000000000000000000000000000110000000000
0000000000000000010000001000001000000010000000000000000000000000000001100000000000000000000000000000000000000000000110000000000
0000000000000000100000001000000000000011000000000000000000000000000001100000000000000000000000000000000000000000000110000000000
0000000000000001100000001000000000000001000000000000000000000000000001100000000000000000000000000000000000000000000110000000000
0000000000000011000000001000000000000000000000000000000000000000000000110000000000000000000000000000000000000000000110000000000
0000000000000010000000001000000000000000000000000000000000000000000000110000000000000000000000000000000000000000000110000000000
0000000000000100000000001000000000000001100000000000000000000000000000011000000000000000000000000000000000000000000110000000000
0000000000001100000000010000000000001011000000000000000000000000000000011100000000000000000000000000000000000000000100000000000
0000000000001000000000000000000000111011000000000000000000000000000000001100000000000000000000000000000000000000000100000000000
0000000000011000000000000000000000000101000000000000000000000000000000000110000000000000000000000000000000000000000100000000000
0000000000010000000000000000000000110101000000000000000000000000000000000111000000000000000000000000010000000000000100000000000
0000000000010000000000000000000000011000100000000000000000000000000000000011100000000000000000000000010000000000000100000000000
0000000000110000000000000000000000000000000000000000000000000000000000000001110000000000000000000000010000000000001100000000000
0000000000100000000000000000000000000000100000000000000000000000000000000000111000000000000000000000010000000000001000000000000
0000000001100000000000000000000000000000000000000000000000000000000000000000011100000000000000000000010000000001001000000000000
0000000001100000000000000000000000000000100000000000000000000000000000000000000110000001100000000000110000000011001000000000000
0000000001100000000000000000011111000001100000000000000000000000000000000000001011100000100000000000110000000110001000000000000
0000000001100000000000000000111111111111001100000000000000000000000000000000001000111100100000000000100000011000010000000000000
0000000001000000000000000001100000001000001111000000000000000000000000000000001000000000100000000000100111100000010000000000000
0000000011000000000000000000000000000000000011110000000000000000000000000000001100000000110000000000100000000000010000000000000
0000000011000000000000000000000000000000000000111100000000000000000000000000000100000000010000000001100000001100010000000000000
0000000011000000000000000000000000000000000000001110000000000000000000000000000110000000011000000001000000001000010000000000000
0000000011000000000000000000000000000000000000000011000000000000000000000000000010000000011000000001000000001000010000000000000
0000000011000000000000000000000000000000000000000001100000000000000000000000000011000001001000000001000000001000010000000000000
0000000011000000000000000000000000000000000000000000110000000000000000000000000001000001001000000001000000001000010000000000000
0000000011000000000000000000000000000000000000000000011000000000000000000000000001100001001100000011000000001000011100000000000
0000000011000000000000000000000000000000000000000000001100000000000000000000000001100001001100000010000000001100001010000000000
0000000011000000000000000000000000000000000000000000001110000000000000000000000000100011001100000010000000001100010010000000000
0000000001100000000000000000000000000000000000000000000110000000000000000000000000110011001100000110000000000110101100000000000
0000000001100000000000000000000000000000000000000000000011000000000000000000000000110011001100000100000000000001111000000000000
0000000001100000000000000000000000000000000000000000000011000000000000000000000000010011000100000100000000000000000000000000000
0000000001100000000000000000000000000000000000000000000001000000000000000000000000010011001100000100000000000000000000000000000
0000000001100000000000000000000000000000000000000000000001100000000000000000000000010001001100000100000000000000000000000000000
0000000000110000000000000000000000000000000000000000000001100000000000000000000000010001001100000100000000000000000000000000000
0000000000110000000000000000000000000000000000000000000001100000000000000000000000110001001000000100000000000000000000000000000
0000000000111000000000000000000000000000000000000000000000100000000000000000000000100001001000000100000000000000000000000000000
0000000000011000000000000000000000000000000000000000000000100000000000000000000001100001001000000100000000000000000000000000000
0000000000011100000000000000000000000000000000000000000000100000000000000000000011000001011000000100000000000000000000000000000
0000000000001100000000000000000000000000000000000000000000100000000000000000000110000001010110100100000000000000000000000000000
0000000000000110000000000000000000001000000000000000000000110000000000000000000111010001010101101100000000000000000000000000000
0000000000000011000000000000000000011000000000000000000000110000000000000000000111110011010101111000000000000000000000000000000
0000000000000001100000000000000000001000000000000000000000010000000000000000000011101100000101110000000000000000000000000000000
0000000000000010110000001100000000001100000000000000000000011000000000000000000000000000000000000000000000000000000000000000000
0000000000000010011100001100000000001100000000000000000000011000000000000000000000000000000000000000000000000000000000000000000
0000000000000010000111000110000000001100000000000000000000001100000000000000000000000000000000000000000000000000000000000000000
0000000000000010000001100110000000001100000000000000000000001100000000000000000000000000000000000000000000000000000000000000000
0000000000000011000000000110000000001000000000000000000000000110000000000000000000000000000000000000000000000000000000000000000
0000000000000011000000000010000000001000000000000000110000000011000000000000000000000000000000000000000000000000000000000000000
0000000000000011000000001010000000001000000000000011100010100001100000000000000000000000000000000000000000000000000000000000000
0000000000000001100000001010000000011000000000001110000011000000111000000000000000000110000000000000000000000000000000000000000
0000000000000000100000001010000000010111111111111000000001000000001110000000000000000001000000000000000000000000000000000000000
0000000000000000100000001110000000010011111111000000000111100000000011100000000010000001000000000000000000000000000000000000000
0000000000000000010000001110000000110000000000000010000010110000000000111111111100000011000000000000000000000000000000000000000
0000000000000000010000001110000000100001000000100010000010011000000000000000000000000010000000000000000000000000000000000000000
0000000000000000011000001010000000100011000001000010000010001110000000000000000000000110000000000000000000000000000000000000000
0000000000000000001000001010000001101100000011000010000010000111000000000000000000001100000000000000000000000000000000000000000
0000000000000000001000001010000001010000000010000010000010000001110000000000000000110000000000000000000000000000000000000000000
0000000000000000000100011010000001111011000110000010000011000000011110000000000111100000000000000000000000000000000000000000000
0000000000000000000100010010000010111100011100000100101001000000000111111111111100000000000000000000000000000000000000000000000
0000000000000000000100010010000010000111110000000110001111000000000000000000000000000000000000000000000000000000000000000000000
0000000000000000000100010010000110000000000000000011111100000000000000000000000000000000000000000000000000000000000000000000000
0000000000000000000100010010000100000000000000000000010000000000000000000000000000000000000000000000000000000000000000000000000
0000000000000000001100010010000100000000000000000000000000000000000000000000000000000000000000000000000000000000000000000000000
0000000000000000001000010010000100000000000000000000000000000000000000000000000000000000000000000000000000000000000000000000000
0000000000000000010000010010001000000000000000000000000000000000000000000000000000000000000000000000000000000000000000000000000
0000000000000000100000010100001000000000000000000000000000000000000000000000000000000000000000000000000000000000000000000000000
0000000000000001100000010100000100000000000000000000000000000000000000000000000000000000000000000000000000000000000000000000000
0000000000000001010110010100000100000000000000000000000000000000000000000000000000000000000000000000000000000000000000000000000
0000000000000001110100101000000100000000000000000000000000000000000000000000000000000000000000000000000000000000000000000000000
0000000000000000010101101010010100000000000000000000000000000000000000000000000000000000000000000000000000000000000000000000000
0000000000000000000101001010010100000000000000000000000000000000000000000000000000000000000000000000000000000000000000000000000
0000000000000000000000011010010100000000000000000000000000000000000000000000000000000000000000000000000000000000000000000000000
0000000000000000000000000010110000000000000000000000000000000000000000000000000000000000000000000000000000000000000000000000000
0000000000000000000000000000000000000000000000000000000000000000000000000000000000000000000000000000000000000000000000000000000
0000000000000000000000000000000000000000000000000000000000000000000000000000000000000000000000000000000000000000000000000000000
0000000000000000000000000000000000000000000000000000000000000000000000000000000000000000000000000000000000000000000000000000000
